1111111111111111111
11000000000CCCEC101
10CCC0000000CCCC011
10CCC00000000000011
10CCC000000CCC00011
10CCC00000000000011
10CCC00000000000011
10CCC00000000000011
10P0011100001111111
100000C000011000011
1111111111111111111