1111111
10PEC11
1CCCC01
1111111