111111111111111111
100000000000000001
100CE0000000000001
10P111110000111101
100000000000000001
100000011100000001
100000000000000001
100100000000110001
111111111111111111