111111111111111111
10P000000000000001
1000E0000000000001
100111110000111101
100000000000000001
100000011100000001
100000000000000001
100100000000110C01
111111111111111111