1111111111111111111
11000100000C0000101
10CCC100000000E0011
10P0011100001111111
100000CC00001100001
1111111111111111111