111111111111
100000C000P1
1000E0000011
111111111111 