111111111111
10P000C00001
1000E00000010
111111111111