111111111111
10P000C00001
1000E0000001
111111111111