1111111111111111111
11000100000C00001C1
10CCC000000000000C1
10P0011100C00111111
100000E000001100001
1111111111111111111